BBBBBBBBBBBBBBBBBBBB
B                  B
B                  B
B         BBBBBBBBBB
B    B             B
B                  B
B               BBBB
B                  B
B      B           B
B                  B
B  B              BB
B                BBB
BB    BBBBBB    BBBB
B              BBBBB
BBBBBBBBBBBBBBBBBBBB
